4
4
P._.######
....######
W._.######
..X_######
##########
##########
##########
##########
##########