4
4
P.W.######
....######
_._.######
._X.######
##########
##########
##########
##########
##########