8
8
_.......##
........##
...._...##
_..WX__.##
.._._...##
.....W..##
.._.....##
P.._....##
##########